######################
#   #   ## ##     #   
# #   #       ### # ##
# # #  ##  ####   # ##
### ######    ### #  #
#          ##  ##    #
##### ######   ##### #
#     #   #######  # #
# #######      S #   #
#                # ###
################## ###
